SQL注入	SQL隱碼攻擊
PN結	PN接面
U盤	隨身碟
彙編	彙編 組譯
借記卡	簽帳金融卡
吉布堤	吉布地
咖喱	咖哩
坦桑尼亞	坦尚尼亞
壁紙	桌布 壁紙
岡比亞	甘比亞
嵌套	巢狀
引導程序	載入程式
支持	支援
意大利	義大利
捲積	摺積
#插件	外掛
搜索	搜尋
# 映射	對映
桌面型	桌上型
概率	機率
構造函數	建構函式
# 權限	許可權
殺毒	防毒
沙特阿拉伯	沙烏地阿拉伯
海內存知己	海內存知己
添加	新增
滾動條	捲軸
演示文稿	簡報
邏輯門	邏輯閘
酰	醯
鍀	鎝
鐦	鉲
鑥	鎦
關係數據庫	關聯式資料庫
隊列	佇列
音頻	音訊
飛行模式	飛航模式
鼠標	滑鼠
程序	程式
用戶	使用者
烏茲別克斯坦	烏茲別克
無損壓縮	無失真壓縮
狀態欄	狀態列
瑙魯	諾魯
瓦努阿圖	萬那杜
的士	計程車
砹	砈
社區	社羣 社區
端口	埠
筆記本電腦	膝上型電腦
範式	正規化
粘貼	貼上 粘貼
組件	元件
缺省	預設
老撾	寮國
肯尼亞	肯亞
脫機	離線
# 腳本	指令碼
航天飛機	太空梭
莫桑比克	莫三比克
# 菜單	選單 菜單
蘇里南	蘇利南
表達式	表示式 運算式
詞組	片語
變量	變數
貝寧	貝南
贊比亞	尚比亞
蹦極	高空彈跳
輔音	子音
轉義字符	跳脫字元
伯利茲	貝里斯
便攜式	行動式 攜帶型
SQL注入攻擊	SQL隱碼攻擊
克羅地亞	克羅埃西亞
免提	擴音
兼容	相容
地址	地址 位址
土庫曼斯坦	土庫曼
在線	線上
圭亞那	蓋亞那
刀片服務器	刀鋒伺服器
列支敦士登	列支敦斯登
利比里亞	賴比瑞亞
# 刷新	重新整理
刻錄	燒錄
寄存器	暫存器
密鑰	金鑰
審覈	稽覈
寫保護	防寫
寬帶	寬頻
尋址	定址
半角	半形
卡塔爾	卡達
危地馬拉	瓜地馬拉
卸載	解除安裝
塑料	塑膠
塔吉克斯坦	塔吉克
帕勞	帛琉
帶寬	頻寬
前綴	字首
創建	建立
# 參數	引數
句柄	控制代碼
可視化	視覺化
函數	函式
出租車	計程車
加納	迦納
原代碼	原始碼
哥斯達黎加	哥斯大黎加
埃塞俄比亞	衣索比亞
城域網	都會網路
基里巴斯	吉里巴斯
宏	宏 巨集
安提瓜和巴布達	安地卡及巴布達
傅里葉	傅立葉
傳感	感測
# 像素	畫素
僞代碼	虛擬碼
優先級	優先順序
# 優化	最佳化
冒泡排序	氣泡排序
冰棍	冰棒
喫茶小舖	喫茶小舖
單片機	微控制器
回調	回撥
固件	韌體
堆棧	堆疊
場效應管	場效電晶體
奔馳	賓士
奶酪	乳酪
巴巴多斯	巴貝多
巴布亞新幾內亞	巴布亞紐幾內亞
幾內亞比紹	幾內亞比索
幾率	機率
彙編語言	組合語言
後綴	字尾
# 循環	迴圈 循環
散列	雜湊
新西蘭	紐西蘭
方便麪	泡麵 速食麵
採樣	取樣
掃描儀	掃描器
掛斷	結束通話
接口	介面
控件	控制元件
智能	智慧
所羅門羣島	索羅門羣島
批量	批次
# 擴展	擴充套件
標識符	識別符號
比特	位元
溢出	溢位
溫納圖萬	那杜
最終用戶	終端使用者
有損壓縮	有失真壓縮
服務器	伺服器
本地代碼	原生代碼
歐拉	尤拉
正則表達式	正規表示式
死機	宕機
性價比	價效比
性能	效能
截取	擷取
截屏	截圖
拋出	丟擲
拷貝	複製
持久性	永續性
指針	指標
支持者	支持者
析構函數	解構函式
枚舉	列舉
# 查找	查詢
# 查看	檢視
格林納達	格瑞那達
格魯吉亞	喬治亞
波分複用	波長分波多工
波斯尼亞黑塞哥維那	波士尼亞赫塞哥維納
津巴布韋	辛巴威
洪都拉斯	宏都拉斯
# 消息	訊息 消息
涼菜	冷盤
激光	鐳射
激活	啟用
# 連接	連線
# 項目	專案
預處理器	前處理器
頭文件	標頭檔案
香農	夏農
過程式編程	程序式程式設計
遞歸	遞迴
遠程	遠端
適配器	介面卡
高速緩存	快取記憶體
# 默認	預設
黃宏	黃宏
黑客	駭客
# 點擊	點選
金屬氧化物半導體	金氧半導體
鎄	鑀
鎇	鋂
鎿	錼
鏡像	映象
閃存	快閃記憶體
鈁	鍅
鈈	鈽
錄像	錄影
錇	鉳
阿塞拜疆	亞塞拜然
阿拉伯聯合酋長國	阿拉伯聯合大公國
面向對象	物件導向
面向過程	程序導向
# 綁定	繫結
盧旺達	盧安達
目標代碼	目的碼
相冊	相簿
程序不正義	程序不正義
程序員	程式設計師
程序正義	程序正義
紅心大戰	傷心小棧
納米	奈米
純喫茶	純喫茶
索馬里	索馬利亞
編程	程式設計
線程	執行緒
緩存	快取
特立尼達和多巴哥	千里達及托巴哥
登錄	登入
矢量	向量
知識產權	智慧財產權
短信	簡訊
硅	矽
空氣淨化器	空氣清淨機
總線	匯流排
用戶名	使用者名稱
界面	介面
異步	非同步
碼分多址	分碼多重進接
碼率	位元速率
磁盤	磁碟
磁道	磁軌
突尼斯	突尼西亞
窗口	視窗
算子	運算元
# 算法	演算法
聯繫	聯絡
訪問	訪問 存取
# 調用	呼叫
視頻	影片 視訊
視圖	檢視
臺式機	桌上型電腦
萊索托	賴索托
虛擬機	虛擬機器
虛函數	虛擬函式
複印	影印
觸摸	觸控
解釋器	直譯器
芯片	晶片
花屏	破圖
藍屏	藍色畫面
藍牙	藍芽
軟件	軟體
軟驅	軟碟機
三極管	三極體
下拉列表	下拉選單
並行計算	平行計算
中間件	中介軟體
保存	儲存
# 代碼	程式碼 代碼
仙童半導體	快捷半導體
以太網	乙太網
仿真	模擬
交互	互動
二極管	二極體
互聯網	網際網路
人工智能	人工智慧
位圖	點陣圖
低級	低階 低級
佛得角	維德角
乍得	查德
也門	葉門
內存	記憶體
內核	核心
內置	內建
內聯函數	行內函數
元數據	後設資料
元編程	超程式設計
元音	母音
光標	游標
光盤	光碟
光驅	光碟機
全局	全域性
全角	全形
圖標	圖示
圖瓦盧	吐瓦魯
地址欄	位址列
字庫	字型檔
字段	欄位
存儲	儲存
存盤	存檔
分佈式	分散式
# 分區	分割槽
分辨率	解析度
# 實例	例項 實例
實模式	真實模式
對話框	對話方塊
對象	物件 對象
導入	匯入
導出	匯出
尼日利亞	奈及利亞
尼日爾	尼日
博客	部落格
博茨瓦納	波札那
多任務	多工
多態	多型
外置	外接
外鍵	外來鍵
# 命名空間	名稱空間
呼出	撥出
呼叫轉移	來電轉駁
塞舌爾	塞席爾
布基納法索	布吉納法索
布爾	布林
布隆迪	蒲隆地
剪切	剪下
剪貼板	剪貼簿
參數表	參數列
局域網	區域網
局部	區域性
屏幕	螢幕
屏蔽	遮蔽
函數式編程	函數語言程式設計
加蓬	加彭
加載	載入
厄瓜多爾	厄瓜多
厄立特里亞	厄利垂亞
哈希	雜湊
哈薩克斯坦	哈薩克
宏內核	單核心
數據	資料
數字	數字 數位
數組	陣列
文件	檔案
文字處理	文書處理
文萊	汶萊
斯威士蘭	史瓦濟蘭
斯洛文尼亞	斯洛維尼亞
採樣率	取樣率
時鐘頻率	時脈頻率
晶閘管	閘流體
晶體管	電晶體
打印	列印
# 打開	開啟 打開
操作數	運算元
擴展名	副檔名
模擬	模擬 類比
模塊	模組
比特幣	比特幣
比特率	位元率
毛里塔尼亞	茅利塔尼亞
毛里求斯	模里西斯
源代碼	原始碼
源文件	原始檔
源碼	原始碼
通信	通訊
通訊卡	通話卡
連接器	聯結器
# 進制	進位制
進程	程序 進程
頁眉	頁首
頁腳	頁尾
頻分多址	分頻多重進接
頻分複用	分頻多工
首席信息官	資訊長
首席執行官	執行長
首席技術官	技術長
首席運營官	營運長
馬爾代夫	馬爾地夫
馬里共和國	馬利共和國
運算符	運算子
運行	執行
集成	整合
集羣	叢集
雲存儲	雲端儲存
雲計算	雲端計算
顯像管	映象管
# 顯卡	顯示卡
顯存	視訊記憶體
# 類型	型別
類模板	類别範本
高性能計算	高效能運算
高清	高畫質
高端	高階 進階
高級	高階 進階 高級
默認值	預設值
重命名	重新命名
鏈接	連結
鏈表	連結串列
門戶網站	入口網站
門電路	閘電路
移動資料	行動資料
科摩羅	葛摩
科特迪瓦	象牙海岸
網上鄰居	網路上的芳鄰
網絡	網路
網關	閘道器
盤片	碟片
盤符	磁碟機代號
編程語言	程式語言
物理內存	實體記憶體
物理地址	實體地址
# 發佈	釋出
發送	傳送
硬件	硬體
硬盤	硬碟
空分多址	分空間多重進接
空分複用	空間多工
縮略圖	縮圖
縮進	縮排
聖基茨和尼維斯	聖克里斯多福及尼維斯
聖文森特和格林納丁斯	聖文森及格瑞那丁
聖盧西亞	聖露西亞
聖馬力諾	聖馬利諾
聯繫歷史	通話記錄
聲卡	音效卡
聲明	宣告
註銷	登出
計算機安全	電腦保安
計算機科學	電腦科學
# 設備	裝置
設置	設定
調試	除錯 偵錯
調色板	調色盤
調製解調器	數據機
調制	調變
調度	排程
視頻會議	視訊會議
視頻通話	視訊通話
自動轉屏	自動旋轉螢幕
自行車	腳踏車
萬維網	全球資訊網
萬象	永珍
虛擬機器	虛擬機器
複選按鈕	覈取按鈕
複選框	覈取方塊
觸摸屏	觸控式螢幕
串行	序列
串口	串列埠
主引導記錄	主開機記錄
主板	主機板
信息	資訊
信噪比	訊雜比
信號	訊號 信號
信道	通道
代碼頁	內碼表
任務欄	工作列
任務管理器	工作管理員
交互式	互動式
圖像	影象
圖庫	相簿
字符	字元
字節	位元組
多米尼加	多明尼加
多線程	多執行緒
命令式編程	指令式程式設計
命令行	命令列
塞拉利昂	獅子山
塞浦路斯	塞普勒斯
數字印刷	數位印刷
文件擴展名	副檔名
# 文本	文字
文檔	文件
時分多址	分時多重進接
時分複用	分時多工
打印機	印表機
操作符	運算子
通過	透過 通過
通配符	萬用字元
集成電路	積體電路
重裝	重灌
重載	過載
移動硬盤	行動硬碟
移動網絡	行動網路
移動通信	行動通訊
移動電話	行動電話
# 網卡	網絡卡
網吧	網咖
註冊機	序號產生器
註冊表	登錄檔
調試器	偵錯程式
串行端口	串列埠
信息安全	資訊保安
信息技術	資訊科技
信息論	資訊理論
字符串	字串
字符集	字符集
數據倉庫	資料倉儲
數據報	資料包
數據庫	資料庫
數據挖掘	資料探勘
數據源	資料來源
數字電子	數位電子
數字電路	數位電路
文件名	檔名
文件夾	資料夾
模擬電子	類比電子
模擬電路	類比電路
魯棒	強健
# 操作系統	作業系統
