爲	為
牀	床
痹	痺
癡	痴
皁	皂
祕	秘
竈	灶
糉	粽
繮	韁
羣	群
僞	偽
啓	啟
嫺	嫻
嬀	媯
幺	么
擡	抬
棱	稜
檐	簷
污	汙
泄	洩
脣	唇
衆	眾
覈	核
踊	踴
鉢	缽
鍼	針
鮎	鯰
麪	麵
齶	顎
着	著
睾	睪
潙	溈
潨	潀
蔘	參
蔿	蒍
